1111111111
1000001001
10X0001001
1110000001
1000000001
1000111101
1000000001
1111010001
10000100Y1
1111111111